##%%%%##%%%%##%%%%##
#                  #
#%%%            %%%#
####            ####
#                  #
#                  #
%    %%%%%%%%%%    %
%    ##########    %
%                  %
# 0              1 #
#%%%            %%%#
####            ####
#                  #
#                  #
##%%%%##%%%%##%%%%##
