##%%%%##%%%%##%%%%##
#                  #
#%%%            %%%#
####            ####
#                  #
#    0        1    #
%    %%%%%%%%%%    %
%    ##########    %
%                  %
#                  #
#%%%            %%%#
####            ####
#                  #
#                  #
##%%%%##%%%%##%%%%##
