##    ##    ##    ##
#                  #
#                  #
#   #%#      #%#   #
#                  #
#       %##%       #
     0        1     
  #%#%#      #%#%#  
                    
#       %##%       #
##                ##
#   #%#      #%#   #
#                  #
#%%%%%%%%%%%%%%%%%%#
##%%%%##%%%%##%%%%##
