##    ##    ##    ##
#                  #
#                  #
#   #%#      #%#   #
#                  #
#       #%%#       #
     0        1     
  #%#%#      #%#%#  
                    
#       #%%#       #
##                ##
#   #%#      #%#   #
#                  #
#%%%%%%%%%%%%%%%%%%#
##%%%%##%%%%##%%%%##
